# Arabic Presentation Forms-A 0FB50 - 0FDFF
FB50	alefwasla.isol	ARABIC LETTER ALEF WASLA ISOLATED FORM
FB51	alefwasla.fina	ARABIC LETTER ALEF WASLA FINAL FORM
FB52	beeh.isol	ARABIC LETTER BEEH ISOLATED FORM
FB53	beeh.fina	ARABIC LETTER BEEH FINAL FORM
FB54	beeh.init	ARABIC LETTER BEEH INITIAL FORM
FB55	beeh.medi	ARABIC LETTER BEEH MEDIAL FORM
FB56	peh.isol	ARABIC LETTER PEH ISOLATED FORM
FB57	peh.fina	ARABIC LETTER PEH FINAL FORM
FB58	peh.init	ARABIC LETTER PEH INITIAL FORM
FB59	peh.medi	ARABIC LETTER PEH MEDIAL FORM
FB5A	beheh.isol	ARABIC LETTER BEHEH ISOLATED FORM
FB5B	beheh.fina	ARABIC LETTER BEHEH FINAL FORM
FB5C	beheh.init	ARABIC LETTER BEHEH INITIAL FORM
FB5D	beheh.medi	ARABIC LETTER BEHEH MEDIAL FORM
FB5E	tteheh.isol	ARABIC LETTER TTEHEH ISOLATED FORM
FB5F	tteheh.fina	ARABIC LETTER TTEHEH FINAL FORM
FB60	tteheh.init	ARABIC LETTER TTEHEH INITIAL FORM
FB61	tteheh.medi	ARABIC LETTER TTEHEH MEDIAL FORM
FB62	teheh.isol	ARABIC LETTER TEHEH ISOLATED FORM
FB63	teheh.fina	ARABIC LETTER TEHEH FINAL FORM
FB64	teheh.init	ARABIC LETTER TEHEH INITIAL FORM
FB65	teheh.medi	ARABIC LETTER TEHEH MEDIAL FORM
FB66	tteh.isol	ARABIC LETTER TTEH ISOLATED FORM
FB67	tteh.fina	ARABIC LETTER TTEH FINAL FORM
FB68	tteh.init	ARABIC LETTER TTEH INITIAL FORM
FB69	tteh.medi	ARABIC LETTER TTEH MEDIAL FORM
FB6A	veh.isol	ARABIC LETTER VEH ISOLATED FORM
FB6B	veh.fina	ARABIC LETTER VEH FINAL FORM
FB6C	veh.init	ARABIC LETTER VEH INITIAL FORM
FB6D	veh.medi	ARABIC LETTER VEH MEDIAL FORM
FB6E	peheh.isol	ARABIC LETTER PEHEH ISOLATED FORM
FB6F	peheh.fina	ARABIC LETTER PEHEH FINAL FORM
FB70	peheh.init	ARABIC LETTER PEHEH INITIAL FORM
FB71	peheh.medi	ARABIC LETTER PEHEH MEDIAL FORM
FB72	dyeh.isol	ARABIC LETTER DYEH ISOLATED FORM
FB73	dyeh.fina	ARABIC LETTER DYEH FINAL FORM
FB74	dyeh.init	ARABIC LETTER DYEH INITIAL FORM
FB75	dyeh.medi	ARABIC LETTER DYEH MEDIAL FORM
FB76	nyeh.isol	ARABIC LETTER NYEH ISOLATED FORM
FB77	nyeh.fina	ARABIC LETTER NYEH FINAL FORM
FB78	nyeh.init	ARABIC LETTER NYEH INITIAL FORM
FB79	nyeh.medi	ARABIC LETTER NYEH MEDIAL FORM
FB7A	tcheh.isol	ARABIC LETTER TCHEH ISOLATED FORM
FB7B	tcheh.fina	ARABIC LETTER TCHEH FINAL FORM
FB7C	tcheh.init	ARABIC LETTER TCHEH INITIAL FORM
FB7D	tcheh.medi	ARABIC LETTER TCHEH MEDIAL FORM
FB7E	tcheheh.isol	ARABIC LETTER TCHEHEH ISOLATED FORM
FB7F	tcheheh.fina	ARABIC LETTER TCHEHEH FINAL FORM
FB80	tcheheh.init	ARABIC LETTER TCHEHEH INITIAL FORM
FB81	tcheheh.medi	ARABIC LETTER TCHEHEH MEDIAL FORM
FB82	ddahal.isol	ARABIC LETTER DDAHAL ISOLATED FORM
FB83	ddahal.fina	ARABIC LETTER DDAHAL FINAL FORM
FB84	dahal.isol	ARABIC LETTER DAHAL ISOLATED FORM
FB85	dahal.fina	ARABIC LETTER DAHAL FINAL FORM
FB86	dul.isol	ARABIC LETTER DUL ISOLATED FORM
FB87	dul.fina	ARABIC LETTER DUL FINAL FORM
FB88	ddal.isol	ARABIC LETTER DDAL ISOLATED FORM
FB89	ddal.fina	ARABIC LETTER DDAL FINAL FORM
FB8A	jeh.isol	ARABIC LETTER JEH ISOLATED FORM
FB8B	jeh.fina	ARABIC LETTER JEH FINAL FORM
FB8C	rreh.isol	ARABIC LETTER RREH ISOLATED FORM
FB8D	rreh.fina	ARABIC LETTER RREH FINAL FORM
FB8E	keheh.isol	ARABIC LETTER KEHEH ISOLATED FORM
FB8F	keheh.fina	ARABIC LETTER KEHEH FINAL FORM
FB90	keheh.init	ARABIC LETTER KEHEH INITIAL FORM
FB91	keheh.medi	ARABIC LETTER KEHEH MEDIAL FORM
FB92	gaf.isol	ARABIC LETTER GAF ISOLATED FORM
FB93	gaf.fina	ARABIC LETTER GAF FINAL FORM
FB94	gaf.init	ARABIC LETTER GAF INITIAL FORM
FB95	gaf.medi	ARABIC LETTER GAF MEDIAL FORM
FB96	gueh.isol	ARABIC LETTER GUEH ISOLATED FORM
FB97	gueh.fina	ARABIC LETTER GUEH FINAL FORM
FB98	gueh.init	ARABIC LETTER GUEH INITIAL FORM
FB99	gueh.medi	ARABIC LETTER GUEH MEDIAL FORM
FB9A	ngoeh.isol	ARABIC LETTER NGOEH ISOLATED FORM
FB9B	ngoeh.fina	ARABIC LETTER NGOEH FINAL FORM
FB9C	ngoeh.init	ARABIC LETTER NGOEH INITIAL FORM
FB9D	ngoeh.medi	ARABIC LETTER NGOEH MEDIAL FORM
FB9E	noonghunna.isol	ARABIC LETTER NOON GHUNNA ISOLATED FORM
FB9F	noonghunna.fina	ARABIC LETTER NOON GHUNNA FINAL FORM
FBA0	rnoon.isol	ARABIC LETTER RNOON ISOLATED FORM
FBA1	rnoon.fina	ARABIC LETTER RNOON FINAL FORM
FBA2	rnoon.init	ARABIC LETTER RNOON INITIAL FORM
FBA3	rnoon.medi	ARABIC LETTER RNOON MEDIAL FORM
FBA4	hehyeh.isol	ARABIC LETTER HEH WITH YEH ABOVE ISOLATED FORM
FBA5	hehyeh.fina	ARABIC LETTER HEH WITH YEH ABOVE FINAL FORM
FBA6	hehgoal.isol	ARABIC LETTER HEH GOAL ISOLATED FORM
FBA7	hehgoal.fina	ARABIC LETTER HEH GOAL FINAL FORM
FBA8	hehgoal.init	ARABIC LETTER HEH GOAL INITIAL FORM
FBA9	hehgoal.medi	ARABIC LETTER HEH GOAL MEDIAL FORM
FBAA	hehdoachashmee.isol	ARABIC LETTER HEH DOACHASHMEE ISOLATED FORM
FBAB	hehdoachashmee.fina	ARABIC LETTER HEH DOACHASHMEE FINAL FORM
FBAC	hehdoachashmee.init	ARABIC LETTER HEH DOACHASHMEE INITIAL FORM
FBAD	hehdoachashmee.medi	ARABIC LETTER HEH DOACHASHMEE MEDIAL FORM
FBAE	yehbarree.isol	ARABIC LETTER YEH BARREE ISOLATED FORM
FBAF	yehbarree.fina	ARABIC LETTER YEH BARREE FINAL FORM
FBB0	yehbarreehamza.isol	ARABIC LETTER YEH BARREE WITH HAMZA ABOVE ISOLATED FORM
FBB1	yehbarreehamza.fina	ARABIC LETTER YEH BARREE WITH HAMZA ABOVE FINAL FORM
FBB2	symboldotabove	ARABIC SYMBOL DOT ABOVE
FBB3	symboldotbelow	ARABIC SYMBOL DOT BELOW
FBB4	symboltwodotsabove	ARABIC SYMBOL TWO DOTS ABOVE
FBB5	symboltwodotsbelow	ARABIC SYMBOL TWO DOTS BELOW
FBB6	symbolabovethreedotsabove	ARABIC SYMBOL THREE DOTS ABOVE
FBB7	symbolbelowthreedotsabove	ARABIC SYMBOL THREE DOTS BELOW
FBB8	symbolpointingabovedownthreedotsabove	ARABIC SYMBOL THREE DOTS POINTING DOWNWARDS ABOVE
FBB9	symbolpointingbelowdownthreedotsabove	ARABIC SYMBOL THREE DOTS POINTING DOWNWARDS BELOW
FBBA	symbolfourdotsabove	ARABIC SYMBOL FOUR DOTS ABOVE
FBBB	symbolfourdotsbelow	ARABIC SYMBOL FOUR DOTS BELOW
FBBC	symboldoubleverticalbarbelow	ARABIC SYMBOL DOUBLE VERTICAL BAR BELOW
FBBD	symboltwodotsverticallyabove	ARABIC SYMBOL TWO DOTS VERTICALLY ABOVE
FBBE	symboltwodotsverticallybelow	ARABIC SYMBOL TWO DOTS VERTICALLY BELOW
FBBF	symbolring	ARABIC SYMBOL RING
FBC0	symboltahabovesmall	ARABIC SYMBOL SMALL TAH ABOVE
FBC1	symboltahbelowsmall	ARABIC SYMBOL SMALL TAH BELOW
FBD3	ng.isol	ARABIC LETTER NG ISOLATED FORM
FBD4	ng.fina	ARABIC LETTER NG FINAL FORM
FBD5	ng.init	ARABIC LETTER NG INITIAL FORM
FBD6	ng.medi	ARABIC LETTER NG MEDIAL FORM
FBD7	u.isol	ARABIC LETTER U ISOLATED FORM
FBD8	u.fina	ARABIC LETTER U FINAL FORM
FBD9	oe.isol	ARABIC LETTER OE ISOLATED FORM
FBDA	oe.fina	ARABIC LETTER OE FINAL FORM
FBDB	yu.isol	ARABIC LETTER YU ISOLATED FORM
FBDC	yu.fina	ARABIC LETTER YU FINAL FORM
FBDD	uhamza.isol	ARABIC LETTER U WITH HAMZA ABOVE ISOLATED FORM
FBDE	ve.isol	ARABIC LETTER VE ISOLATED FORM
FBDF	ve.fina	ARABIC LETTER VE FINAL FORM
FBE0	oekirghiz.isol	ARABIC LETTER KIRGHIZ OE ISOLATED FORM
FBE1	oekirghiz.fina	ARABIC LETTER KIRGHIZ OE FINAL FORM
FBE2	yukirghiz.isol	ARABIC LETTER KIRGHIZ YU ISOLATED FORM
FBE3	yukirghiz.fina	ARABIC LETTER KIRGHIZ YU FINAL FORM
FBE4	e.isol	ARABIC LETTER E ISOLATED FORM
FBE5	e.fina	ARABIC LETTER E FINAL FORM
FBE6	e.init	ARABIC LETTER E INITIAL FORM
FBE7	e.medi	ARABIC LETTER E MEDIAL FORM
FBE8	uighurkazakhkirghizalefmaksura.init	ARABIC LETTER UIGHUR KAZAKH KIRGHIZ ALEF MAKSURA INITIAL FORM
FBE9	uighurkazakhkirghizalefmaksura.medi	ARABIC LETTER UIGHUR KAZAKH KIRGHIZ ALEF MAKSURA MEDIAL FORM
FBEA	yeh.init_hamzaabove.medi_alef.fina	ARABIC LIGATURE YEH WITH HAMZA ABOVE WITH ALEF ISOLATED FORM
FBEB	yeh.medi_hamzaabove.medi_alef.fina	ARABIC LIGATURE YEH WITH HAMZA ABOVE WITH ALEF FINAL FORM
FBEC	yeh.init_hamzaabove.medi_ae.fina	ARABIC LIGATURE YEH WITH HAMZA ABOVE WITH AE ISOLATED FORM
FBED	yeh.medi_hamzaabove.medi_ae.fina	ARABIC LIGATURE YEH WITH HAMZA ABOVE WITH AE FINAL FORM
FBEE	yeh.init_hamzaabove.medi_waw.fina	ARABIC LIGATURE YEH WITH HAMZA ABOVE WITH WAW ISOLATED FORM
FBEF	yeh.medi_hamzaabove.medi_waw.fina	ARABIC LIGATURE YEH WITH HAMZA ABOVE WITH WAW FINAL FORM
FBF0	yeh.init_hamzaabove.medi_u.fina	ARABIC LIGATURE YEH WITH HAMZA ABOVE WITH U ISOLATED FORM
FBF1	yeh.medi_hamzaabove.medi_u.fina	ARABIC LIGATURE YEH WITH HAMZA ABOVE WITH U FINAL FORM
FBF2	yeh.init_hamzaabove.medi_oe.fina	ARABIC LIGATURE YEH WITH HAMZA ABOVE WITH OE ISOLATED FORM
FBF3	yeh.medi_hamzaabove.medi_oe.fina	ARABIC LIGATURE YEH WITH HAMZA ABOVE WITH OE FINAL FORM
FBF4	yeh.init_hamzaabove.medi_yu.fina	ARABIC LIGATURE YEH WITH HAMZA ABOVE WITH YU ISOLATED FORM
FBF5	yeh.medi_hamzaabove.medi_yu.fina	ARABIC LIGATURE YEH WITH HAMZA ABOVE WITH YU FINAL FORM
FBF6	yeh.init_hamzaabove.medi_e.fina	ARABIC LIGATURE YEH WITH HAMZA ABOVE WITH E ISOLATED FORM
FBF7	yeh.medi_hamzaabove.medi_e.fina	ARABIC LIGATURE YEH WITH HAMZA ABOVE WITH E FINAL FORM
FBF8	yeh.init_hamzaabove.medi_e.medi	ARABIC LIGATURE YEH WITH HAMZA ABOVE WITH E INITIAL FORM
FBF9	uighurkirghizyeh.init_hamzaabove.medi_alefmaksura.fina	ARABIC LIGATURE UIGHUR KIRGHIZ YEH WITH HAMZA ABOVE WITH ALEF MAKSURA ISOLATED FORM
FBFA	uighurkirghizyeh.medi_hamzaabove.medi_alefmaksura.fina	ARABIC LIGATURE UIGHUR KIRGHIZ YEH WITH HAMZA ABOVE WITH ALEF MAKSURA FINAL FORM
FBFB	uighurkirghizyeh.init_hamzaabove.medi_alefmaksura.medi	ARABIC LIGATURE UIGHUR KIRGHIZ YEH WITH HAMZA ABOVE WITH ALEF MAKSURA INITIAL FORM
FBFC	yehfarsi.isol	ARABIC LETTER FARSI YEH ISOLATED FORM
FBFD	yehfarsi.fina	ARABIC LETTER FARSI YEH FINAL FORM
FBFE	yehfarsi.init	ARABIC LETTER FARSI YEH INITIAL FORM
FBFF	yehfarsi.medi	ARABIC LETTER FARSI YEH MEDIAL FORM
FC00	yeh.init_hamzaabove.medi_jeem.fina	ARABIC LIGATURE YEH WITH HAMZA ABOVE WITH JEEM ISOLATED FORM
FC01	yeh.init_hamzaabove.medi_hah.fina	ARABIC LIGATURE YEH WITH HAMZA ABOVE WITH HAH ISOLATED FORM
FC02	yeh.init_hamzaabove.medi_meem.fina	ARABIC LIGATURE YEH WITH HAMZA ABOVE WITH MEEM ISOLATED FORM
FC03	yeh.init_hamzaabove.medi_alefmaksura.fina	ARABIC LIGATURE YEH WITH HAMZA ABOVE WITH ALEF MAKSURA ISOLATED FORM
FC04	yeh.init_hamzaabove.medi_yeh.fina	ARABIC LIGATURE YEH WITH HAMZA ABOVE WITH YEH ISOLATED FORM
FC05	beh.init_jeem.fina	ARABIC LIGATURE BEH WITH JEEM ISOLATED FORM
FC06	beh.init_hah.fina	ARABIC LIGATURE BEH WITH HAH ISOLATED FORM
FC07	beh.init_khah.fina	ARABIC LIGATURE BEH WITH KHAH ISOLATED FORM
FC08	beh.init_meem.fina	ARABIC LIGATURE BEH WITH MEEM ISOLATED FORM
FC09	beh.init_alefmaksura.fina	ARABIC LIGATURE BEH WITH ALEF MAKSURA ISOLATED FORM
FC0A	beh.init_yeh.fina	ARABIC LIGATURE BEH WITH YEH ISOLATED FORM
FC0B	teh.init_jeem.fina	ARABIC LIGATURE TEH WITH JEEM ISOLATED FORM
FC0C	teh.init_hah.fina	ARABIC LIGATURE TEH WITH HAH ISOLATED FORM
FC0D	teh.init_khah.fina	ARABIC LIGATURE TEH WITH KHAH ISOLATED FORM
FC0E	teh.init_meem.fina	ARABIC LIGATURE TEH WITH MEEM ISOLATED FORM
FC0F	teh.init_alefmaksura.fina	ARABIC LIGATURE TEH WITH ALEF MAKSURA ISOLATED FORM
FC10	teh.init_yeh.fina	ARABIC LIGATURE TEH WITH YEH ISOLATED FORM
FC11	theh.init_jeem.fina	ARABIC LIGATURE THEH WITH JEEM ISOLATED FORM
FC12	theh.init_meem.fina	ARABIC LIGATURE THEH WITH MEEM ISOLATED FORM
FC13	theh.init_alefmaksura.fina	ARABIC LIGATURE THEH WITH ALEF MAKSURA ISOLATED FORM
FC14	theh.init_yeh.fina	ARABIC LIGATURE THEH WITH YEH ISOLATED FORM
FC15	jeem.init_hah.fina	ARABIC LIGATURE JEEM WITH HAH ISOLATED FORM
FC16	jeem.init_meem.fina	ARABIC LIGATURE JEEM WITH MEEM ISOLATED FORM
FC17	hah.init_jeem.fina	ARABIC LIGATURE HAH WITH JEEM ISOLATED FORM
FC18	hah.init_meem.fina	ARABIC LIGATURE HAH WITH MEEM ISOLATED FORM
FC19	khah.init_jeem.fina	ARABIC LIGATURE KHAH WITH JEEM ISOLATED FORM
FC1A	khah.init_hah.fina	ARABIC LIGATURE KHAH WITH HAH ISOLATED FORM
FC1B	khah.init_meem.fina	ARABIC LIGATURE KHAH WITH MEEM ISOLATED FORM
FC1C	seen.init_jeem.fina	ARABIC LIGATURE SEEN WITH JEEM ISOLATED FORM
FC1D	seen.init_hah.fina	ARABIC LIGATURE SEEN WITH HAH ISOLATED FORM
FC1E	seen.init_khah.fina	ARABIC LIGATURE SEEN WITH KHAH ISOLATED FORM
FC1F	seen.init_meem.fina	ARABIC LIGATURE SEEN WITH MEEM ISOLATED FORM
FC20	sad.init_hah.fina	ARABIC LIGATURE SAD WITH HAH ISOLATED FORM
FC21	sad.init_meem.fina	ARABIC LIGATURE SAD WITH MEEM ISOLATED FORM
FC22	dad.init_jeem.fina	ARABIC LIGATURE DAD WITH JEEM ISOLATED FORM
FC23	dad.init_hah.fina	ARABIC LIGATURE DAD WITH HAH ISOLATED FORM
FC24	dad.init_khah.fina	ARABIC LIGATURE DAD WITH KHAH ISOLATED FORM
FC25	dad.init_meem.fina	ARABIC LIGATURE DAD WITH MEEM ISOLATED FORM
FC26	tah.init_hah.fina	ARABIC LIGATURE TAH WITH HAH ISOLATED FORM
FC27	tah.init_meem.fina	ARABIC LIGATURE TAH WITH MEEM ISOLATED FORM
FC28	zah.init_meem.fina	ARABIC LIGATURE ZAH WITH MEEM ISOLATED FORM
FC29	ain.init_jeem.fina	ARABIC LIGATURE AIN WITH JEEM ISOLATED FORM
FC2A	ain.init_meem.fina	ARABIC LIGATURE AIN WITH MEEM ISOLATED FORM
FC2B	ghain.init_jeem.fina	ARABIC LIGATURE GHAIN WITH JEEM ISOLATED FORM
FC2C	ghain.init_meem.fina	ARABIC LIGATURE GHAIN WITH MEEM ISOLATED FORM
FC2D	feh.init_jeem.fina	ARABIC LIGATURE FEH WITH JEEM ISOLATED FORM
FC2E	feh.init_hah.fina	ARABIC LIGATURE FEH WITH HAH ISOLATED FORM
FC2F	feh.init_khah.fina	ARABIC LIGATURE FEH WITH KHAH ISOLATED FORM
FC30	feh.init_meem.fina	ARABIC LIGATURE FEH WITH MEEM ISOLATED FORM
FC31	feh.init_alefmaksura.fina	ARABIC LIGATURE FEH WITH ALEF MAKSURA ISOLATED FORM
FC32	feh.init_yeh.fina	ARABIC LIGATURE FEH WITH YEH ISOLATED FORM
FC33	qaf.init_hah.fina	ARABIC LIGATURE QAF WITH HAH ISOLATED FORM
FC34	qaf.init_meem.fina	ARABIC LIGATURE QAF WITH MEEM ISOLATED FORM
FC35	qaf.init_alefmaksura.fina	ARABIC LIGATURE QAF WITH ALEF MAKSURA ISOLATED FORM
FC36	qaf.init_yeh.fina	ARABIC LIGATURE QAF WITH YEH ISOLATED FORM
FC37	kaf.init_alef.fina	ARABIC LIGATURE KAF WITH ALEF ISOLATED FORM
FC38	kaf.init_jeem.fina	ARABIC LIGATURE KAF WITH JEEM ISOLATED FORM
FC39	kaf.init_hah.fina	ARABIC LIGATURE KAF WITH HAH ISOLATED FORM
FC3A	kaf.init_khah.fina	ARABIC LIGATURE KAF WITH KHAH ISOLATED FORM
FC3B	kaf.init_lam.fina	ARABIC LIGATURE KAF WITH LAM ISOLATED FORM
FC3C	kaf.init_meem.fina	ARABIC LIGATURE KAF WITH MEEM ISOLATED FORM
FC3D	kaf.init_alefmaksura.fina	ARABIC LIGATURE KAF WITH ALEF MAKSURA ISOLATED FORM
FC3E	kaf.init_yeh.fina	ARABIC LIGATURE KAF WITH YEH ISOLATED FORM
FC3F	lam.init_jeem.fina	ARABIC LIGATURE LAM WITH JEEM ISOLATED FORM
FC40	lam.init_hah.fina	ARABIC LIGATURE LAM WITH HAH ISOLATED FORM
FC41	lam.init_khah.fina	ARABIC LIGATURE LAM WITH KHAH ISOLATED FORM
FC42	lam.init_meem.fina	ARABIC LIGATURE LAM WITH MEEM ISOLATED FORM
FC43	lam.init_alefmaksura.fina	ARABIC LIGATURE LAM WITH ALEF MAKSURA ISOLATED FORM
FC44	lam.init_yeh.fina	ARABIC LIGATURE LAM WITH YEH ISOLATED FORM
FC45	meem.init_jeem.fina	ARABIC LIGATURE MEEM WITH JEEM ISOLATED FORM
FC46	meem.init_hah.fina	ARABIC LIGATURE MEEM WITH HAH ISOLATED FORM
FC47	meem.init_khah.fina	ARABIC LIGATURE MEEM WITH KHAH ISOLATED FORM
FC48	meem.init_meem.fina	ARABIC LIGATURE MEEM WITH MEEM ISOLATED FORM
FC49	meem.init_alefmaksura.fina	ARABIC LIGATURE MEEM WITH ALEF MAKSURA ISOLATED FORM
FC4A	meem.init_yeh.fina	ARABIC LIGATURE MEEM WITH YEH ISOLATED FORM
FC4B	noon.init_jeem.fina	ARABIC LIGATURE NOON WITH JEEM ISOLATED FORM
FC4C	noon.init_hah.fina	ARABIC LIGATURE NOON WITH HAH ISOLATED FORM
FC4D	noon.init_khah.fina	ARABIC LIGATURE NOON WITH KHAH ISOLATED FORM
FC4E	noon.init_meem.fina	ARABIC LIGATURE NOON WITH MEEM ISOLATED FORM
FC4F	noon.init_alefmaksura.fina	ARABIC LIGATURE NOON WITH ALEF MAKSURA ISOLATED FORM
FC50	noon.init_yeh.fina	ARABIC LIGATURE NOON WITH YEH ISOLATED FORM
FC51	heh.init_jeem.fina	ARABIC LIGATURE HEH WITH JEEM ISOLATED FORM
FC52	heh.init_meem.fina	ARABIC LIGATURE HEH WITH MEEM ISOLATED FORM
FC53	heh.init_alefmaksura.fina	ARABIC LIGATURE HEH WITH ALEF MAKSURA ISOLATED FORM
FC54	heh.init_yeh.fina	ARABIC LIGATURE HEH WITH YEH ISOLATED FORM
FC55	yeh.init_jeem.fina	ARABIC LIGATURE YEH WITH JEEM ISOLATED FORM
FC56	yeh.init_hah.fina	ARABIC LIGATURE YEH WITH HAH ISOLATED FORM
FC57	yeh.init_khah.fina	ARABIC LIGATURE YEH WITH KHAH ISOLATED FORM
FC58	yeh.init_meem.fina	ARABIC LIGATURE YEH WITH MEEM ISOLATED FORM
FC59	yeh.init_alefmaksura.fina	ARABIC LIGATURE YEH WITH ALEF MAKSURA ISOLATED FORM
FC5A	yeh.init_yeh.fina	ARABIC LIGATURE YEH WITH YEH ISOLATED FORM
FC5B	thal.init_superscriptalef.fina	ARABIC LIGATURE THAL WITH SUPERSCRIPT ALEF ISOLATED FORM
FC5C	reh.init_superscriptalef.fina	ARABIC LIGATURE REH WITH SUPERSCRIPT ALEF ISOLATED FORM
FC5D	alefmaksura.init_superscriptalef.fina	ARABIC LIGATURE ALEF MAKSURA WITH SUPERSCRIPT ALEF ISOLATED FORM
FC5E	shaddaDammatanIsol	ARABIC LIGATURE SHADDA WITH DAMMATAN ISOLATED FORM
FC5F	shaddaKasratanIsol	ARABIC LIGATURE SHADDA WITH KASRATAN ISOLATED FORM
FC60	shaddaFathaIsol	ARABIC LIGATURE SHADDA WITH FATHA ISOLATED FORM
FC61	shaddaDammaIsol	ARABIC LIGATURE SHADDA WITH DAMMA ISOLATED FORM
FC62	shaddaKasraIsol	ARABIC LIGATURE SHADDA WITH KASRA ISOLATED FORM
FC63	shaddaAlefIsol	ARABIC LIGATURE SHADDA WITH SUPERSCRIPT ALEF ISOLATED FORM
FC64	yeh.medi_hamzaabove.medi_reh.fina	ARABIC LIGATURE YEH WITH HAMZA ABOVE WITH REH FINAL FORM
FC65	yeh.medi_hamzaabove.medi_zain.fina	ARABIC LIGATURE YEH WITH HAMZA ABOVE WITH ZAIN FINAL FORM
FC66	yeh.medi_hamzaabove.medi_meem.fina	ARABIC LIGATURE YEH WITH HAMZA ABOVE WITH MEEM FINAL FORM
FC67	yeh.medi_hamzaabove.medi_noon.fina	ARABIC LIGATURE YEH WITH HAMZA ABOVE WITH NOON FINAL FORM
FC68	yeh.medi_hamzaabove.medi_alefmaksura.fina	ARABIC LIGATURE YEH WITH HAMZA ABOVE WITH ALEF MAKSURA FINAL FORM
FC69	yeh.medi_hamzaabove.medi_yeh.fina	ARABIC LIGATURE YEH WITH HAMZA ABOVE WITH YEH FINAL FORM
FC6A	beh.medi_reh.fina	ARABIC LIGATURE BEH WITH REH FINAL FORM
FC6B	beh.medi_zain.fina	ARABIC LIGATURE BEH WITH ZAIN FINAL FORM
FC6C	beh.medi_meem.fina	ARABIC LIGATURE BEH WITH MEEM FINAL FORM
FC6D	beh.medi_noon.fina	ARABIC LIGATURE BEH WITH NOON FINAL FORM
FC6E	beh.medi_alefmaksura.fina	ARABIC LIGATURE BEH WITH ALEF MAKSURA FINAL FORM
FC6F	beh.medi_yeh.fina	ARABIC LIGATURE BEH WITH YEH FINAL FORM
FC70	teh.medi_reh.fina	ARABIC LIGATURE TEH WITH REH FINAL FORM
FC71	teh.medi_zain.fina	ARABIC LIGATURE TEH WITH ZAIN FINAL FORM
FC72	teh.medi_meem.fina	ARABIC LIGATURE TEH WITH MEEM FINAL FORM
FC73	teh.medi_noon.fina	ARABIC LIGATURE TEH WITH NOON FINAL FORM
FC74	teh.medi_alefmaksura.fina	ARABIC LIGATURE TEH WITH ALEF MAKSURA FINAL FORM
FC75	teh.medi_yeh.fina	ARABIC LIGATURE TEH WITH YEH FINAL FORM
FC76	theh.medi_reh.fina	ARABIC LIGATURE THEH WITH REH FINAL FORM
FC77	theh.medi_zain.fina	ARABIC LIGATURE THEH WITH ZAIN FINAL FORM
FC78	theh.medi_meem.fina	ARABIC LIGATURE THEH WITH MEEM FINAL FORM
FC79	theh.medi_noon.fina	ARABIC LIGATURE THEH WITH NOON FINAL FORM
FC7A	theh.medi_alefmaksura.fina	ARABIC LIGATURE THEH WITH ALEF MAKSURA FINAL FORM
FC7B	theh.medi_yeh.fina	ARABIC LIGATURE THEH WITH YEH FINAL FORM
FC7C	feh.medi_alefmaksura.fina	ARABIC LIGATURE FEH WITH ALEF MAKSURA FINAL FORM
FC7D	feh.medi_yeh.fina	ARABIC LIGATURE FEH WITH YEH FINAL FORM
FC7E	qaf.medi_alefmaksura.fina	ARABIC LIGATURE QAF WITH ALEF MAKSURA FINAL FORM
FC7F	qaf.medi_yeh.fina	ARABIC LIGATURE QAF WITH YEH FINAL FORM
FC80	kaf.medi_alef.fina	ARABIC LIGATURE KAF WITH ALEF FINAL FORM
FC81	kaf.medi_lam.fina	ARABIC LIGATURE KAF WITH LAM FINAL FORM
FC82	kaf.medi_meem.fina	ARABIC LIGATURE KAF WITH MEEM FINAL FORM
FC83	kaf.medi_alefmaksura.fina	ARABIC LIGATURE KAF WITH ALEF MAKSURA FINAL FORM
FC84	kaf.medi_yeh.fina	ARABIC LIGATURE KAF WITH YEH FINAL FORM
FC85	lam.medi_meem.fina	ARABIC LIGATURE LAM WITH MEEM FINAL FORM
FC86	lam.medi_alefmaksura.fina	ARABIC LIGATURE LAM WITH ALEF MAKSURA FINAL FORM
FC87	lam.medi_yeh.fina	ARABIC LIGATURE LAM WITH YEH FINAL FORM
FC88	meem.medi_alef.fina	ARABIC LIGATURE MEEM WITH ALEF FINAL FORM
FC89	meem.medi_meem.fina	ARABIC LIGATURE MEEM WITH MEEM FINAL FORM
FC8A	noon.medi_reh.fina	ARABIC LIGATURE NOON WITH REH FINAL FORM
FC8B	noon.medi_zain.fina	ARABIC LIGATURE NOON WITH ZAIN FINAL FORM
FC8C	noon.medi_meem.fina	ARABIC LIGATURE NOON WITH MEEM FINAL FORM
FC8D	noon.medi_noon.fina	ARABIC LIGATURE NOON WITH NOON FINAL FORM
FC8E	noon.medi_alefmaksura.fina	ARABIC LIGATURE NOON WITH ALEF MAKSURA FINAL FORM
FC8F	noon.medi_yeh.fina	ARABIC LIGATURE NOON WITH YEH FINAL FORM
FC90	alefmaksura.medi_superscriptalef.fina	ARABIC LIGATURE ALEF MAKSURA WITH SUPERSCRIPT ALEF FINAL FORM
FC91	yeh.medi_reh.fina	ARABIC LIGATURE YEH WITH REH FINAL FORM
FC92	yeh.medi_zain.fina	ARABIC LIGATURE YEH WITH ZAIN FINAL FORM
FC93	yeh.medi_meem.fina	ARABIC LIGATURE YEH WITH MEEM FINAL FORM
FC94	yeh.medi_noon.fina	ARABIC LIGATURE YEH WITH NOON FINAL FORM
FC95	yeh.medi_alefmaksura.fina	ARABIC LIGATURE YEH WITH ALEF MAKSURA FINAL FORM
FC96	yeh.medi_yeh.fina	ARABIC LIGATURE YEH WITH YEH FINAL FORM
FC97	yeh.init_hamzaabove.medi_jeem.medi	ARABIC LIGATURE YEH WITH HAMZA ABOVE WITH JEEM INITIAL FORM
FC98	yeh.init_hamzaabove.medi_hah.medi	ARABIC LIGATURE YEH WITH HAMZA ABOVE WITH HAH INITIAL FORM
FC99	yeh.init_hamzaabove.medi_khah.medi	ARABIC LIGATURE YEH WITH HAMZA ABOVE WITH KHAH INITIAL FORM
FC9A	yeh.init_hamzaabove.medi_meem.medi	ARABIC LIGATURE YEH WITH HAMZA ABOVE WITH MEEM INITIAL FORM
FC9B	yeh.init_hamzaabove.medi_heh.medi	ARABIC LIGATURE YEH WITH HAMZA ABOVE WITH HEH INITIAL FORM
FC9C	beh.init_jeem.medi	ARABIC LIGATURE BEH WITH JEEM INITIAL FORM
FC9D	beh.init_hah.medi	ARABIC LIGATURE BEH WITH HAH INITIAL FORM
FC9E	beh.init_khah.medi	ARABIC LIGATURE BEH WITH KHAH INITIAL FORM
FC9F	beh.init_meem.medi	ARABIC LIGATURE BEH WITH MEEM INITIAL FORM
FCA0	beh.init_heh.medi	ARABIC LIGATURE BEH WITH HEH INITIAL FORM
FCA1	teh.init_jeem.medi	ARABIC LIGATURE TEH WITH JEEM INITIAL FORM
FCA2	teh.init_hah.medi	ARABIC LIGATURE TEH WITH HAH INITIAL FORM
FCA3	teh.init_khah.medi	ARABIC LIGATURE TEH WITH KHAH INITIAL FORM
FCA4	teh.init_meem.medi	ARABIC LIGATURE TEH WITH MEEM INITIAL FORM
FCA5	teh.init_heh.medi	ARABIC LIGATURE TEH WITH HEH INITIAL FORM
FCA6	theh.init_meem.medi	ARABIC LIGATURE THEH WITH MEEM INITIAL FORM
FCA7	jeem.init_hah.medi	ARABIC LIGATURE JEEM WITH HAH INITIAL FORM
FCA8	jeem.init_meem.medi	ARABIC LIGATURE JEEM WITH MEEM INITIAL FORM
FCA9	hah.init_jeem.medi	ARABIC LIGATURE HAH WITH JEEM INITIAL FORM
FCAA	hah.init_meem.medi	ARABIC LIGATURE HAH WITH MEEM INITIAL FORM
FCAB	khah.init_jeem.medi	ARABIC LIGATURE KHAH WITH JEEM INITIAL FORM
FCAC	khah.init_meem.medi	ARABIC LIGATURE KHAH WITH MEEM INITIAL FORM
FCAD	seen.init_jeem.medi	ARABIC LIGATURE SEEN WITH JEEM INITIAL FORM
FCAE	seen.init_hah.medi	ARABIC LIGATURE SEEN WITH HAH INITIAL FORM
FCAF	seen.init_khah.medi	ARABIC LIGATURE SEEN WITH KHAH INITIAL FORM
FCB0	seen.init_meem.medi	ARABIC LIGATURE SEEN WITH MEEM INITIAL FORM
FCB1	sad.init_hah.medi	ARABIC LIGATURE SAD WITH HAH INITIAL FORM
FCB2	sad.init_khah.medi	ARABIC LIGATURE SAD WITH KHAH INITIAL FORM
FCB3	sad.init_meem.medi	ARABIC LIGATURE SAD WITH MEEM INITIAL FORM
FCB4	dad.init_jeem.medi	ARABIC LIGATURE DAD WITH JEEM INITIAL FORM
FCB5	dad.init_hah.medi	ARABIC LIGATURE DAD WITH HAH INITIAL FORM
FCB6	dad.init_khah.medi	ARABIC LIGATURE DAD WITH KHAH INITIAL FORM
FCB7	dad.init_meem.medi	ARABIC LIGATURE DAD WITH MEEM INITIAL FORM
FCB8	tah.init_hah.medi	ARABIC LIGATURE TAH WITH HAH INITIAL FORM
FCB9	zah.init_meem.medi	ARABIC LIGATURE ZAH WITH MEEM INITIAL FORM
FCBA	ain.init_jeem.medi	ARABIC LIGATURE AIN WITH JEEM INITIAL FORM
FCBB	ain.init_meem.medi	ARABIC LIGATURE AIN WITH MEEM INITIAL FORM
FCBC	ghain.init_jeem.medi	ARABIC LIGATURE GHAIN WITH JEEM INITIAL FORM
FCBD	ghain.init_meem.medi	ARABIC LIGATURE GHAIN WITH MEEM INITIAL FORM
FCBE	feh.init_jeem.medi	ARABIC LIGATURE FEH WITH JEEM INITIAL FORM
FCBF	feh.init_hah.medi	ARABIC LIGATURE FEH WITH HAH INITIAL FORM
FCC0	feh.init_khah.medi	ARABIC LIGATURE FEH WITH KHAH INITIAL FORM
FCC1	feh.init_meem.medi	ARABIC LIGATURE FEH WITH MEEM INITIAL FORM
FCC2	qaf.init_hah.medi	ARABIC LIGATURE QAF WITH HAH INITIAL FORM
FCC3	qaf.init_meem.medi	ARABIC LIGATURE QAF WITH MEEM INITIAL FORM
FCC4	kaf.init_jeem.medi	ARABIC LIGATURE KAF WITH JEEM INITIAL FORM
FCC5	kaf.init_hah.medi	ARABIC LIGATURE KAF WITH HAH INITIAL FORM
FCC6	kaf.init_khah.medi	ARABIC LIGATURE KAF WITH KHAH INITIAL FORM
FCC7	kaf.init_lam.medi	ARABIC LIGATURE KAF WITH LAM INITIAL FORM
FCC8	kaf.init_meem.medi	ARABIC LIGATURE KAF WITH MEEM INITIAL FORM
FCC9	lam.init_jeem.medi	ARABIC LIGATURE LAM WITH JEEM INITIAL FORM
FCCA	lam.init_hah.medi	ARABIC LIGATURE LAM WITH HAH INITIAL FORM
FCCB	lam.init_khah.medi	ARABIC LIGATURE LAM WITH KHAH INITIAL FORM
FCCC	lam.init_meem.medi	ARABIC LIGATURE LAM WITH MEEM INITIAL FORM
FCCD	lam.init_heh.medi	ARABIC LIGATURE LAM WITH HEH INITIAL FORM
FCCE	meem.init_jeem.medi	ARABIC LIGATURE MEEM WITH JEEM INITIAL FORM
FCCF	meem.init_hah.medi	ARABIC LIGATURE MEEM WITH HAH INITIAL FORM
FCD0	meem.init_khah.medi	ARABIC LIGATURE MEEM WITH KHAH INITIAL FORM
FCD1	meem.init_meem.medi	ARABIC LIGATURE MEEM WITH MEEM INITIAL FORM
FCD2	noon.init_jeem.medi	ARABIC LIGATURE NOON WITH JEEM INITIAL FORM
FCD3	noon.init_hah.medi	ARABIC LIGATURE NOON WITH HAH INITIAL FORM
FCD4	noon.init_khah.medi	ARABIC LIGATURE NOON WITH KHAH INITIAL FORM
FCD5	noon.init_meem.medi	ARABIC LIGATURE NOON WITH MEEM INITIAL FORM
FCD6	noon.init_heh.medi	ARABIC LIGATURE NOON WITH HEH INITIAL FORM
FCD7	heh.init_jeem.medi	ARABIC LIGATURE HEH WITH JEEM INITIAL FORM
FCD8	heh.init_meem.medi	ARABIC LIGATURE HEH WITH MEEM INITIAL FORM
FCD9	heh.init_superscriptalef.medi	ARABIC LIGATURE HEH WITH SUPERSCRIPT ALEF INITIAL FORM
FCDA	yeh.init_jeem.medi	ARABIC LIGATURE YEH WITH JEEM INITIAL FORM
FCDB	yeh.init_hah.medi	ARABIC LIGATURE YEH WITH HAH INITIAL FORM
FCDC	yeh.init_khah.medi	ARABIC LIGATURE YEH WITH KHAH INITIAL FORM
FCDD	yeh.init_meem.medi	ARABIC LIGATURE YEH WITH MEEM INITIAL FORM
FCDE	yeh.init_heh.medi	ARABIC LIGATURE YEH WITH HEH INITIAL FORM
FCDF	yeh.medi_hamzaabove.medi_meem.medi	ARABIC LIGATURE YEH WITH HAMZA ABOVE WITH MEEM MEDIAL FORM
FCE0	yeh.medi_hamzaabove.medi_heh.medi	ARABIC LIGATURE YEH WITH HAMZA ABOVE WITH HEH MEDIAL FORM
FCE1	beh.medi_meem.medi	ARABIC LIGATURE BEH WITH MEEM MEDIAL FORM
FCE2	beh.medi_heh.medi	ARABIC LIGATURE BEH WITH HEH MEDIAL FORM
FCE3	teh.medi_meem.medi	ARABIC LIGATURE TEH WITH MEEM MEDIAL FORM
FCE4	teh.medi_heh.medi	ARABIC LIGATURE TEH WITH HEH MEDIAL FORM
FCE5	theh.medi_meem.medi	ARABIC LIGATURE THEH WITH MEEM MEDIAL FORM
FCE6	theh.medi_heh.medi	ARABIC LIGATURE THEH WITH HEH MEDIAL FORM
FCE7	seen.medi_meem.medi	ARABIC LIGATURE SEEN WITH MEEM MEDIAL FORM
FCE8	seen.medi_heh.medi	ARABIC LIGATURE SEEN WITH HEH MEDIAL FORM
FCE9	sheen.medi_meem.medi	ARABIC LIGATURE SHEEN WITH MEEM MEDIAL FORM
FCEA	sheen.medi_heh.medi	ARABIC LIGATURE SHEEN WITH HEH MEDIAL FORM
FCEB	kaf.medi_lam.medi	ARABIC LIGATURE KAF WITH LAM MEDIAL FORM
FCEC	kaf.medi_meem.medi	ARABIC LIGATURE KAF WITH MEEM MEDIAL FORM
FCED	lam.medi_meem.medi	ARABIC LIGATURE LAM WITH MEEM MEDIAL FORM
FCEE	noon.medi_meem.medi	ARABIC LIGATURE NOON WITH MEEM MEDIAL FORM
FCEF	noon.medi_heh.medi	ARABIC LIGATURE NOON WITH HEH MEDIAL FORM
FCF0	yeh.medi_meem.medi	ARABIC LIGATURE YEH WITH MEEM MEDIAL FORM
FCF1	yeh.medi_heh.medi	ARABIC LIGATURE YEH WITH HEH MEDIAL FORM
FCF2	shaddaFathaMedi	ARABIC LIGATURE SHADDA WITH FATHA MEDIAL FORM
FCF3	shaddaDammaMedi	ARABIC LIGATURE SHADDA WITH DAMMA MEDIAL FORM
FCF4	shaddaKasraMedi	ARABIC LIGATURE SHADDA WITH KASRA MEDIAL FORM
FCF5	tah.init_alefmaksura.fina	ARABIC LIGATURE TAH WITH ALEF MAKSURA ISOLATED FORM
FCF6	tah.init_yeh.fina	ARABIC LIGATURE TAH WITH YEH ISOLATED FORM
FCF7	ain.init_alefmaksura.fina	ARABIC LIGATURE AIN WITH ALEF MAKSURA ISOLATED FORM
FCF8	ain.init_yeh.fina	ARABIC LIGATURE AIN WITH YEH ISOLATED FORM
FCF9	ghain.init_alefmaksura.fina	ARABIC LIGATURE GHAIN WITH ALEF MAKSURA ISOLATED FORM
FCFA	ghain.init_yeh.fina	ARABIC LIGATURE GHAIN WITH YEH ISOLATED FORM
FCFB	seen.init_alefmaksura.fina	ARABIC LIGATURE SEEN WITH ALEF MAKSURA ISOLATED FORM
FCFC	seen.init_yeh.fina	ARABIC LIGATURE SEEN WITH YEH ISOLATED FORM
FCFD	sheen.init_alefmaksura.fina	ARABIC LIGATURE SHEEN WITH ALEF MAKSURA ISOLATED FORM
FCFE	sheen.init_yeh.fina	ARABIC LIGATURE SHEEN WITH YEH ISOLATED FORM
FCFF	hah.init_alefmaksura.fina	ARABIC LIGATURE HAH WITH ALEF MAKSURA ISOLATED FORM
FD00	hah.init_yeh.fina	ARABIC LIGATURE HAH WITH YEH ISOLATED FORM
FD01	jeem.init_alefmaksura.fina	ARABIC LIGATURE JEEM WITH ALEF MAKSURA ISOLATED FORM
FD02	jeem.init_yeh.fina	ARABIC LIGATURE JEEM WITH YEH ISOLATED FORM
FD03	khah.init_alefmaksura.fina	ARABIC LIGATURE KHAH WITH ALEF MAKSURA ISOLATED FORM
FD04	khah.init_yeh.fina	ARABIC LIGATURE KHAH WITH YEH ISOLATED FORM
FD05	sad.init_alefmaksura.fina	ARABIC LIGATURE SAD WITH ALEF MAKSURA ISOLATED FORM
FD06	sad.init_yeh.fina	ARABIC LIGATURE SAD WITH YEH ISOLATED FORM
FD07	dad.init_alefmaksura.fina	ARABIC LIGATURE DAD WITH ALEF MAKSURA ISOLATED FORM
FD08	dad.init_yeh.fina	ARABIC LIGATURE DAD WITH YEH ISOLATED FORM
FD09	sheen.init_jeem.fina	ARABIC LIGATURE SHEEN WITH JEEM ISOLATED FORM
FD0A	sheen.init_hah.fina	ARABIC LIGATURE SHEEN WITH HAH ISOLATED FORM
FD0B	sheen.init_khah.fina	ARABIC LIGATURE SHEEN WITH KHAH ISOLATED FORM
FD0C	sheen.init_meem.fina	ARABIC LIGATURE SHEEN WITH MEEM ISOLATED FORM
FD0D	sheen.init_reh.fina	ARABIC LIGATURE SHEEN WITH REH ISOLATED FORM
FD0E	seen.init_reh.fina	ARABIC LIGATURE SEEN WITH REH ISOLATED FORM
FD0F	sad.init_reh.fina	ARABIC LIGATURE SAD WITH REH ISOLATED FORM
FD10	dad.init_reh.fina	ARABIC LIGATURE DAD WITH REH ISOLATED FORM
FD11	tah.medi_alefmaksura.fina	ARABIC LIGATURE TAH WITH ALEF MAKSURA FINAL FORM
FD12	tah.medi_yeh.fina	ARABIC LIGATURE TAH WITH YEH FINAL FORM
FD13	ain.medi_alefmaksura.fina	ARABIC LIGATURE AIN WITH ALEF MAKSURA FINAL FORM
FD14	ain.medi_yeh.fina	ARABIC LIGATURE AIN WITH YEH FINAL FORM
FD15	ghain.medi_alefmaksura.fina	ARABIC LIGATURE GHAIN WITH ALEF MAKSURA FINAL FORM
FD16	ghain.medi_yeh.fina	ARABIC LIGATURE GHAIN WITH YEH FINAL FORM
FD17	seen.medi_alefmaksura.fina	ARABIC LIGATURE SEEN WITH ALEF MAKSURA FINAL FORM
FD18	seen.medi_yeh.fina	ARABIC LIGATURE SEEN WITH YEH FINAL FORM
FD19	sheen.medi_alefmaksura.fina	ARABIC LIGATURE SHEEN WITH ALEF MAKSURA FINAL FORM
FD1A	sheen.medi_yeh.fina	ARABIC LIGATURE SHEEN WITH YEH FINAL FORM
FD1B	hah.medi_alefmaksura.fina	ARABIC LIGATURE HAH WITH ALEF MAKSURA FINAL FORM
FD1C	hah.medi_yeh.fina	ARABIC LIGATURE HAH WITH YEH FINAL FORM
FD1D	jeem.medi_alefmaksura.fina	ARABIC LIGATURE JEEM WITH ALEF MAKSURA FINAL FORM
FD1E	jeem.medi_yeh.fina	ARABIC LIGATURE JEEM WITH YEH FINAL FORM
FD1F	khah.medi_alefmaksura.fina	ARABIC LIGATURE KHAH WITH ALEF MAKSURA FINAL FORM
FD20	khah.medi_yeh.fina	ARABIC LIGATURE KHAH WITH YEH FINAL FORM
FD21	sad.medi_alefmaksura.fina	ARABIC LIGATURE SAD WITH ALEF MAKSURA FINAL FORM
FD22	sad.medi_yeh.fina	ARABIC LIGATURE SAD WITH YEH FINAL FORM
FD23	dad.medi_alefmaksura.fina	ARABIC LIGATURE DAD WITH ALEF MAKSURA FINAL FORM
FD24	dad.medi_yeh.fina	ARABIC LIGATURE DAD WITH YEH FINAL FORM
FD25	sheen.medi_jeem.fina	ARABIC LIGATURE SHEEN WITH JEEM FINAL FORM
FD26	sheen.medi_hah.fina	ARABIC LIGATURE SHEEN WITH HAH FINAL FORM
FD27	sheen.medi_khah.fina	ARABIC LIGATURE SHEEN WITH KHAH FINAL FORM
FD28	sheen.medi_meem.fina	ARABIC LIGATURE SHEEN WITH MEEM FINAL FORM
FD29	sheen.medi_reh.fina	ARABIC LIGATURE SHEEN WITH REH FINAL FORM
FD2A	seen.medi_reh.fina	ARABIC LIGATURE SEEN WITH REH FINAL FORM
FD2B	sad.medi_reh.fina	ARABIC LIGATURE SAD WITH REH FINAL FORM
FD2C	dad.medi_reh.fina	ARABIC LIGATURE DAD WITH REH FINAL FORM
FD2D	sheen.init_jeem.medi	ARABIC LIGATURE SHEEN WITH JEEM INITIAL FORM
FD2E	sheen.init_hah.medi	ARABIC LIGATURE SHEEN WITH HAH INITIAL FORM
FD2F	sheen.init_khah.medi	ARABIC LIGATURE SHEEN WITH KHAH INITIAL FORM
FD30	sheen.init_meem.medi	ARABIC LIGATURE SHEEN WITH MEEM INITIAL FORM
FD31	seen.init_heh.medi	ARABIC LIGATURE SEEN WITH HEH INITIAL FORM
FD32	sheen.init_heh.medi	ARABIC LIGATURE SHEEN WITH HEH INITIAL FORM
FD33	tah.init_meem.medi	ARABIC LIGATURE TAH WITH MEEM INITIAL FORM
FD34	seen.medi_jeem.medi	ARABIC LIGATURE SEEN WITH JEEM MEDIAL FORM
FD35	seen.medi_hah.medi	ARABIC LIGATURE SEEN WITH HAH MEDIAL FORM
FD36	seen.medi_khah.medi	ARABIC LIGATURE SEEN WITH KHAH MEDIAL FORM
FD37	sheen.medi_jeem.medi	ARABIC LIGATURE SHEEN WITH JEEM MEDIAL FORM
FD38	sheen.medi_hah.medi	ARABIC LIGATURE SHEEN WITH HAH MEDIAL FORM
FD39	sheen.medi_khah.medi	ARABIC LIGATURE SHEEN WITH KHAH MEDIAL FORM
FD3A	tah.medi_meem.medi	ARABIC LIGATURE TAH WITH MEEM MEDIAL FORM
FD3B	zah.medi_meem.medi	ARABIC LIGATURE ZAH WITH MEEM MEDIAL FORM
FD3C	alef.medi_fathatan.fina	ARABIC LIGATURE ALEF WITH FATHATAN FINAL FORM
FD3D	alef.init_fathatan.fina	ARABIC LIGATURE ALEF WITH FATHATAN ISOLATED FORM
FD3E	ornateleftparenthesis	ORNATE LEFT PARENTHESIS
FD3F	ornaterightparenthesis	ORNATE RIGHT PARENTHESIS
FD50	teh.init_jeem.medi_meem.medi	ARABIC LIGATURE TEH WITH JEEM WITH MEEM INITIAL FORM
FD51	teh.medi_hah.medi_jeem.fina	ARABIC LIGATURE TEH WITH HAH WITH JEEM FINAL FORM
FD52	teh.init_hah.medi_jeem.medi	ARABIC LIGATURE TEH WITH HAH WITH JEEM INITIAL FORM
FD53	teh.init_hah.medi_meem.medi	ARABIC LIGATURE TEH WITH HAH WITH MEEM INITIAL FORM
FD54	teh.init_khah.medi_meem.medi	ARABIC LIGATURE TEH WITH KHAH WITH MEEM INITIAL FORM
FD55	teh.init_meem.medi_jeem.medi	ARABIC LIGATURE TEH WITH MEEM WITH JEEM INITIAL FORM
FD56	teh.init_meem.medi_hah.medi	ARABIC LIGATURE TEH WITH MEEM WITH HAH INITIAL FORM
FD57	teh.init_meem.medi_khah.medi	ARABIC LIGATURE TEH WITH MEEM WITH KHAH INITIAL FORM
FD58	jeem.medi_meem.medi_hah.fina	ARABIC LIGATURE JEEM WITH MEEM WITH HAH FINAL FORM
FD59	jeem.init_meem.medi_hah.medi	ARABIC LIGATURE JEEM WITH MEEM WITH HAH INITIAL FORM
FD5A	hah.medi_meem.medi_yeh.fina	ARABIC LIGATURE HAH WITH MEEM WITH YEH FINAL FORM
FD5B	hah.medi_meem.medi_alefmaksura.fina	ARABIC LIGATURE HAH WITH MEEM WITH ALEF MAKSURA FINAL FORM
FD5C	seen.init_hah.medi_jeem.medi	ARABIC LIGATURE SEEN WITH HAH WITH JEEM INITIAL FORM
FD5D	seen.init_jeem.medi_hah.medi	ARABIC LIGATURE SEEN WITH JEEM WITH HAH INITIAL FORM
FD5E	seen.medi_jeem.medi_alefmaksura.fina	ARABIC LIGATURE SEEN WITH JEEM WITH ALEF MAKSURA FINAL FORM
FD5F	seen.medi_meem.medi_hah.fina	ARABIC LIGATURE SEEN WITH MEEM WITH HAH FINAL FORM
FD60	seen.init_meem.medi_hah.medi	ARABIC LIGATURE SEEN WITH MEEM WITH HAH INITIAL FORM
FD61	seen.init_meem.medi_jeem.medi	ARABIC LIGATURE SEEN WITH MEEM WITH JEEM INITIAL FORM
FD62	seen.medi_meem.medi_meem.fina	ARABIC LIGATURE SEEN WITH MEEM WITH MEEM FINAL FORM
FD63	seen.init_meem.medi_meem.medi	ARABIC LIGATURE SEEN WITH MEEM WITH MEEM INITIAL FORM
FD64	sad.medi_hah.medi_hah.fina	ARABIC LIGATURE SAD WITH HAH WITH HAH FINAL FORM
FD65	sad.init_hah.medi_hah.medi	ARABIC LIGATURE SAD WITH HAH WITH HAH INITIAL FORM
FD66	sad.medi_meem.medi_meem.fina	ARABIC LIGATURE SAD WITH MEEM WITH MEEM FINAL FORM
FD67	sheen.medi_hah.medi_meem.fina	ARABIC LIGATURE SHEEN WITH HAH WITH MEEM FINAL FORM
FD68	sheen.init_hah.medi_meem.medi	ARABIC LIGATURE SHEEN WITH HAH WITH MEEM INITIAL FORM
FD69	sheen.medi_jeem.medi_yeh.fina	ARABIC LIGATURE SHEEN WITH JEEM WITH YEH FINAL FORM
FD6A	sheen.medi_meem.medi_khah.fina	ARABIC LIGATURE SHEEN WITH MEEM WITH KHAH FINAL FORM
FD6B	sheen.init_meem.medi_khah.medi	ARABIC LIGATURE SHEEN WITH MEEM WITH KHAH INITIAL FORM
FD6C	sheen.medi_meem.medi_meem.fina	ARABIC LIGATURE SHEEN WITH MEEM WITH MEEM FINAL FORM
FD6D	sheen.init_meem.medi_meem.medi	ARABIC LIGATURE SHEEN WITH MEEM WITH MEEM INITIAL FORM
FD6E	dad.medi_hah.medi_alefmaksura.fina	ARABIC LIGATURE DAD WITH HAH WITH ALEF MAKSURA FINAL FORM
FD6F	dad.medi_khah.medi_meem.fina	ARABIC LIGATURE DAD WITH KHAH WITH MEEM FINAL FORM
FD70	dad.init_khah.medi_meem.medi	ARABIC LIGATURE DAD WITH KHAH WITH MEEM INITIAL FORM
FD71	tah.medi_meem.medi_hah.fina	ARABIC LIGATURE TAH WITH MEEM WITH HAH FINAL FORM
FD72	tah.init_meem.medi_hah.medi	ARABIC LIGATURE TAH WITH MEEM WITH HAH INITIAL FORM
FD73	tah.init_meem.medi_meem.medi	ARABIC LIGATURE TAH WITH MEEM WITH MEEM INITIAL FORM
FD74	tah.medi_meem.medi_yeh.fina	ARABIC LIGATURE TAH WITH MEEM WITH YEH FINAL FORM
FD75	ain.medi_jeem.medi_meem.fina	ARABIC LIGATURE AIN WITH JEEM WITH MEEM FINAL FORM
FD76	ain.medi_meem.medi_meem.fina	ARABIC LIGATURE AIN WITH MEEM WITH MEEM FINAL FORM
FD77	ain.init_meem.medi_meem.medi	ARABIC LIGATURE AIN WITH MEEM WITH MEEM INITIAL FORM
FD78	ain.medi_meem.medi_alefmaksura.fina	ARABIC LIGATURE AIN WITH MEEM WITH ALEF MAKSURA FINAL FORM
FD79	ghain.medi_meem.medi_meem.fina	ARABIC LIGATURE GHAIN WITH MEEM WITH MEEM FINAL FORM
FD7A	ghain.medi_meem.medi_yeh.fina	ARABIC LIGATURE GHAIN WITH MEEM WITH YEH FINAL FORM
FD7B	ghain.medi_meem.medi_alefmaksura.fina	ARABIC LIGATURE GHAIN WITH MEEM WITH ALEF MAKSURA FINAL FORM
FD7C	feh.medi_khah.medi_meem.fina	ARABIC LIGATURE FEH WITH KHAH WITH MEEM FINAL FORM
FD7D	feh.init_khah.medi_meem.medi	ARABIC LIGATURE FEH WITH KHAH WITH MEEM INITIAL FORM
FD7E	qaf.medi_meem.medi_hah.fina	ARABIC LIGATURE QAF WITH MEEM WITH HAH FINAL FORM
FD7F	qaf.medi_meem.medi_meem.fina	ARABIC LIGATURE QAF WITH MEEM WITH MEEM FINAL FORM
FD80	lam.medi_hah.medi_meem.fina	ARABIC LIGATURE LAM WITH HAH WITH MEEM FINAL FORM
FD81	lam.medi_hah.medi_yeh.fina	ARABIC LIGATURE LAM WITH HAH WITH YEH FINAL FORM
FD82	lam.medi_hah.medi_alefmaksura.fina	ARABIC LIGATURE LAM WITH HAH WITH ALEF MAKSURA FINAL FORM
FD83	lam.init_jeem.medi_jeem.medi	ARABIC LIGATURE LAM WITH JEEM WITH JEEM INITIAL FORM
FD84	lam.medi_jeem.medi_jeem.fina	ARABIC LIGATURE LAM WITH JEEM WITH JEEM FINAL FORM
FD85	lam.medi_khah.medi_meem.fina	ARABIC LIGATURE LAM WITH KHAH WITH MEEM FINAL FORM
FD86	lam.init_khah.medi_meem.medi	ARABIC LIGATURE LAM WITH KHAH WITH MEEM INITIAL FORM
FD87	lam.medi_meem.medi_hah.fina	ARABIC LIGATURE LAM WITH MEEM WITH HAH FINAL FORM
FD88	lam.init_meem.medi_hah.medi	ARABIC LIGATURE LAM WITH MEEM WITH HAH INITIAL FORM
FD89	meem.init_hah.medi_jeem.medi	ARABIC LIGATURE MEEM WITH HAH WITH JEEM INITIAL FORM
FD8A	meem.init_hah.medi_meem.medi	ARABIC LIGATURE MEEM WITH HAH WITH MEEM INITIAL FORM
FD8B	meem.medi_hah.medi_yeh.fina	ARABIC LIGATURE MEEM WITH HAH WITH YEH FINAL FORM
FD8C	meem.init_jeem.medi_hah.medi	ARABIC LIGATURE MEEM WITH JEEM WITH HAH INITIAL FORM
FD8D	meem.init_jeem.medi_meem.medi	ARABIC LIGATURE MEEM WITH JEEM WITH MEEM INITIAL FORM
FD8E	meem.init_khah.medi_jeem.medi	ARABIC LIGATURE MEEM WITH KHAH WITH JEEM INITIAL FORM
FD8F	meem.init_khah.medi_meem.medi	ARABIC LIGATURE MEEM WITH KHAH WITH MEEM INITIAL FORM
FD92	meem.init_jeem.medi_khah.medi	ARABIC LIGATURE MEEM WITH JEEM WITH KHAH INITIAL FORM
FD93	heh.init_meem.medi_jeem.medi	ARABIC LIGATURE HEH WITH MEEM WITH JEEM INITIAL FORM
FD94	heh.init_meem.medi_meem.medi	ARABIC LIGATURE HEH WITH MEEM WITH MEEM INITIAL FORM
FD95	noon.init_hah.medi_meem.medi	ARABIC LIGATURE NOON WITH HAH WITH MEEM INITIAL FORM
FD96	noon.medi_hah.medi_alefmaksura.fina	ARABIC LIGATURE NOON WITH HAH WITH ALEF MAKSURA FINAL FORM
FD97	noon.medi_jeem.medi_meem.fina	ARABIC LIGATURE NOON WITH JEEM WITH MEEM FINAL FORM
FD98	noon.init_jeem.medi_meem.medi	ARABIC LIGATURE NOON WITH JEEM WITH MEEM INITIAL FORM
FD99	noon.medi_jeem.medi_alefmaksura.fina	ARABIC LIGATURE NOON WITH JEEM WITH ALEF MAKSURA FINAL FORM
FD9A	noon.medi_meem.medi_yeh.fina	ARABIC LIGATURE NOON WITH MEEM WITH YEH FINAL FORM
FD9B	noon.medi_meem.medi_alefmaksura.fina	ARABIC LIGATURE NOON WITH MEEM WITH ALEF MAKSURA FINAL FORM
FD9C	yeh.medi_meem.medi_meem.fina	ARABIC LIGATURE YEH WITH MEEM WITH MEEM FINAL FORM
FD9D	yeh.init_meem.medi_meem.medi	ARABIC LIGATURE YEH WITH MEEM WITH MEEM INITIAL FORM
FD9E	beh.medi_khah.medi_yeh.fina	ARABIC LIGATURE BEH WITH KHAH WITH YEH FINAL FORM
FD9F	teh.medi_jeem.medi_yeh.fina	ARABIC LIGATURE TEH WITH JEEM WITH YEH FINAL FORM
FDA0	teh.medi_jeem.medi_alefmaksura.fina	ARABIC LIGATURE TEH WITH JEEM WITH ALEF MAKSURA FINAL FORM
FDA1	teh.medi_khah.medi_yeh.fina	ARABIC LIGATURE TEH WITH KHAH WITH YEH FINAL FORM
FDA2	teh.medi_khah.medi_alefmaksura.fina	ARABIC LIGATURE TEH WITH KHAH WITH ALEF MAKSURA FINAL FORM
FDA3	teh.medi_meem.medi_yeh.fina	ARABIC LIGATURE TEH WITH MEEM WITH YEH FINAL FORM
FDA4	teh.medi_meem.medi_alefmaksura.fina	ARABIC LIGATURE TEH WITH MEEM WITH ALEF MAKSURA FINAL FORM
FDA5	jeem.medi_meem.medi_yeh.fina	ARABIC LIGATURE JEEM WITH MEEM WITH YEH FINAL FORM
FDA6	jeem.medi_hah.medi_alefmaksura.fina	ARABIC LIGATURE JEEM WITH HAH WITH ALEF MAKSURA FINAL FORM
FDA7	jeem.medi_meem.medi_alefmaksura.fina	ARABIC LIGATURE JEEM WITH MEEM WITH ALEF MAKSURA FINAL FORM
FDA8	seen.medi_khah.medi_alefmaksura.fina	ARABIC LIGATURE SEEN WITH KHAH WITH ALEF MAKSURA FINAL FORM
FDA9	sad.medi_hah.medi_yeh.fina	ARABIC LIGATURE SAD WITH HAH WITH YEH FINAL FORM
FDAA	sheen.medi_hah.medi_yeh.fina	ARABIC LIGATURE SHEEN WITH HAH WITH YEH FINAL FORM
FDAB	dad.medi_hah.medi_yeh.fina	ARABIC LIGATURE DAD WITH HAH WITH YEH FINAL FORM
FDAC	lam.medi_jeem.medi_yeh.fina	ARABIC LIGATURE LAM WITH JEEM WITH YEH FINAL FORM
FDAD	lam.medi_meem.medi_yeh.fina	ARABIC LIGATURE LAM WITH MEEM WITH YEH FINAL FORM
FDAE	yeh.medi_hah.medi_yeh.fina	ARABIC LIGATURE YEH WITH HAH WITH YEH FINAL FORM
FDAF	yeh.medi_jeem.medi_yeh.fina	ARABIC LIGATURE YEH WITH JEEM WITH YEH FINAL FORM
FDB0	yeh.medi_meem.medi_yeh.fina	ARABIC LIGATURE YEH WITH MEEM WITH YEH FINAL FORM
FDB1	meem.medi_meem.medi_yeh.fina	ARABIC LIGATURE MEEM WITH MEEM WITH YEH FINAL FORM
FDB2	qaf.medi_meem.medi_yeh.fina	ARABIC LIGATURE QAF WITH MEEM WITH YEH FINAL FORM
FDB3	noon.medi_hah.medi_yeh.fina	ARABIC LIGATURE NOON WITH HAH WITH YEH FINAL FORM
FDB4	qaf.init_meem.medi_hah.medi	ARABIC LIGATURE QAF WITH MEEM WITH HAH INITIAL FORM
FDB5	lam.init_hah.medi_meem.medi	ARABIC LIGATURE LAM WITH HAH WITH MEEM INITIAL FORM
FDB6	ain.medi_meem.medi_yeh.fina	ARABIC LIGATURE AIN WITH MEEM WITH YEH FINAL FORM
FDB7	kaf.medi_meem.medi_yeh.fina	ARABIC LIGATURE KAF WITH MEEM WITH YEH FINAL FORM
FDB8	noon.init_jeem.medi_hah.medi	ARABIC LIGATURE NOON WITH JEEM WITH HAH INITIAL FORM
FDB9	meem.medi_khah.medi_yeh.fina	ARABIC LIGATURE MEEM WITH KHAH WITH YEH FINAL FORM
FDBA	lam.init_jeem.medi_meem.medi	ARABIC LIGATURE LAM WITH JEEM WITH MEEM INITIAL FORM
FDBB	kaf.medi_meem.medi_meem.fina	ARABIC LIGATURE KAF WITH MEEM WITH MEEM FINAL FORM
FDBC	lam.medi_jeem.medi_meem.fina	ARABIC LIGATURE LAM WITH JEEM WITH MEEM FINAL FORM
FDBD	noon.medi_jeem.medi_hah.fina	ARABIC LIGATURE NOON WITH JEEM WITH HAH FINAL FORM
FDBE	jeem.medi_hah.medi_yeh.fina	ARABIC LIGATURE JEEM WITH HAH WITH YEH FINAL FORM
FDBF	hah.medi_jeem.medi_yeh.fina	ARABIC LIGATURE HAH WITH JEEM WITH YEH FINAL FORM
FDC0	meem.medi_jeem.medi_yeh.fina	ARABIC LIGATURE MEEM WITH JEEM WITH YEH FINAL FORM
FDC1	feh.medi_meem.medi_yeh.fina	ARABIC LIGATURE FEH WITH MEEM WITH YEH FINAL FORM
FDC2	beh.medi_hah.medi_yeh.fina	ARABIC LIGATURE BEH WITH HAH WITH YEH FINAL FORM
FDC3	kaf.init_meem.medi_meem.medi	ARABIC LIGATURE KAF WITH MEEM WITH MEEM INITIAL FORM
FDC4	ain.init_jeem.medi_meem.medi	ARABIC LIGATURE AIN WITH JEEM WITH MEEM INITIAL FORM
FDC5	sad.init_meem.medi_meem.medi	ARABIC LIGATURE SAD WITH MEEM WITH MEEM INITIAL FORM
FDC6	seen.medi_khah.medi_yeh.fina	ARABIC LIGATURE SEEN WITH KHAH WITH YEH FINAL FORM
FDC7	noon.medi_jeem.medi_yeh.fina	ARABIC LIGATURE NOON WITH JEEM WITH YEH FINAL FORM
FDF0	SallaUsedAsKoranicStopSign	ARABIC LIGATURE SALLA USED AS KORANIC STOP SIGN ISOLATED FORM
FDF1	QalaUsedAsKoranicStopSign	ARABIC LIGATURE QALA USED AS KORANIC STOP SIGN ISOLATED FORM
FDF2	Allah	ARABIC LIGATURE ALLAH ISOLATED FORM
FDF3	Akbar	ARABIC LIGATURE AKBAR ISOLATED FORM
FDF4	Mohammad	ARABIC LIGATURE MOHAMMAD ISOLATED FORM
FDF5	Salam	ARABIC LIGATURE SALAM ISOLATED FORM
FDF6	Rasoul	ARABIC LIGATURE RASOUL ISOLATED FORM
FDF7	Alayhe	ARABIC LIGATURE ALAYHE ISOLATED FORM
FDF8	Wasallam	ARABIC LIGATURE WASALLAM ISOLATED FORM
FDF9	Salla	ARABIC LIGATURE SALLA ISOLATED FORM
FDFA	SallallahouAlayheWasallam	ARABIC LIGATURE SALLALLAHOU ALAYHE WASALLAM
FDFB	Jallajalalouhou	ARABIC LIGATURE JALLAJALALOUHOU
FDFC	rial	RIAL SIGN
FDFD	BismillahArRahmanArRaheem	ARABIC LIGATURE BISMILLAH AR-RAHMAN AR-RAHEEM