# Arabic Presentation Forms-B 0FE70 - 0FEFF
FE70	fathatanIsol	ARABIC FATHATAN ISOLATED FORM
FE71	tatweelFathatanAbove	ARABIC TATWEEL WITH FATHATAN ABOVE
FE72	dammatanIsol	ARABIC DAMMATAN ISOLATED FORM
FE73	kashidaFina	ARABIC TAIL FRAGMENT
FE74	kasratanIsol	ARABIC KASRATAN ISOLATED FORM
FE76	fathaIsol	ARABIC FATHA ISOLATED FORM
FE77	fathaMedi	ARABIC FATHA MEDIAL FORM
FE78	dammaIsol	ARABIC DAMMA ISOLATED FORM
FE79	dammaMedi	ARABIC DAMMA MEDIAL FORM
FE7A	kasraIsol	ARABIC KASRA ISOLATED FORM
FE7B	kasraMedi	ARABIC KASRA MEDIAL FORM
FE7C	shaddaIsol	ARABIC SHADDA ISOLATED FORM
FE7D	shaddaMedi	ARABIC SHADDA MEDIAL FORM
FE7E	sukunIsol	ARABIC SUKUN ISOLATED FORM
FE7F	sukunMedi	ARABIC SUKUN MEDIAL FORM
FE80	hamzaIsol	ARABIC LETTER HAMZA ISOLATED FORM
FE81	alefmadda.isol	ARABIC LETTER ALEF WITH MADDA ABOVE ISOLATED FORM
FE82	alefmadda.fina	ARABIC LETTER ALEF WITH MADDA ABOVE FINAL FORM
FE83	alefhamza.isol	ARABIC LETTER ALEF WITH HAMZA ABOVE ISOLATED FORM
FE84	alefhamza.fina	ARABIC LETTER ALEF WITH HAMZA ABOVE FINAL FORM
FE85	wawhamza.isol	ARABIC LETTER WAW WITH HAMZA ABOVE ISOLATED FORM
FE86	wawhamza.fina	ARABIC LETTER WAW WITH HAMZA ABOVE FINAL FORM
FE87	alefhamzabelow.isol	ARABIC LETTER ALEF WITH HAMZA BELOW ISOLATED FORM
FE88	alefhamzabelow.fina	ARABIC LETTER ALEF WITH HAMZA BELOW FINAL FORM
FE89	yehhamza.isol	ARABIC LETTER YEH WITH HAMZA ABOVE ISOLATED FORM
FE8A	yehhamza.fina	ARABIC LETTER YEH WITH HAMZA ABOVE FINAL FORM
FE8B	yehhamza.init	ARABIC LETTER YEH WITH HAMZA ABOVE INITIAL FORM
FE8C	yehhamza.medi	ARABIC LETTER YEH WITH HAMZA ABOVE MEDIAL FORM
FE8D	alef.isol	ARABIC LETTER ALEF ISOLATED FORM
FE8E	alef.fina	ARABIC LETTER ALEF FINAL FORM
FE8F	beh.isol	ARABIC LETTER BEH ISOLATED FORM
FE90	beh.fina	ARABIC LETTER BEH FINAL FORM
FE91	beh.init	ARABIC LETTER BEH INITIAL FORM
FE92	beh.medi	ARABIC LETTER BEH MEDIAL FORM
FE93	tehmarbuta.isol	ARABIC LETTER TEH MARBUTA ISOLATED FORM
FE94	tehmarbuta.fina	ARABIC LETTER TEH MARBUTA FINAL FORM
FE95	teh.isol	ARABIC LETTER TEH ISOLATED FORM
FE96	teh.fina	ARABIC LETTER TEH FINAL FORM
FE97	teh.init	ARABIC LETTER TEH INITIAL FORM
FE98	teh.medi	ARABIC LETTER TEH MEDIAL FORM
FE99	theh.isol	ARABIC LETTER THEH ISOLATED FORM
FE9A	theh.fina	ARABIC LETTER THEH FINAL FORM
FE9B	theh.init	ARABIC LETTER THEH INITIAL FORM
FE9C	theh.medi	ARABIC LETTER THEH MEDIAL FORM
FE9D	jeem.isol	ARABIC LETTER JEEM ISOLATED FORM
FE9E	jeem.fina	ARABIC LETTER JEEM FINAL FORM
FE9F	jeem.init	ARABIC LETTER JEEM INITIAL FORM
FEA0	jeem.medi	ARABIC LETTER JEEM MEDIAL FORM
FEA1	hah.isol	ARABIC LETTER HAH ISOLATED FORM
FEA2	hah.fina	ARABIC LETTER HAH FINAL FORM
FEA3	hah.init	ARABIC LETTER HAH INITIAL FORM
FEA4	hah.medi	ARABIC LETTER HAH MEDIAL FORM
FEA5	khah.isol	ARABIC LETTER KHAH ISOLATED FORM
FEA6	khah.fina	ARABIC LETTER KHAH FINAL FORM
FEA7	khah.init	ARABIC LETTER KHAH INITIAL FORM
FEA8	khah.medi	ARABIC LETTER KHAH MEDIAL FORM
FEA9	dal.isol	ARABIC LETTER DAL ISOLATED FORM
FEAA	dal.fina	ARABIC LETTER DAL FINAL FORM
FEAB	thal.isol	ARABIC LETTER THAL ISOLATED FORM
FEAC	thal.fina	ARABIC LETTER THAL FINAL FORM
FEAD	reh.isol	ARABIC LETTER REH ISOLATED FORM
FEAE	reh.fina	ARABIC LETTER REH FINAL FORM
FEAF	zain.isol	ARABIC LETTER ZAIN ISOLATED FORM
FEB0	zain.fina	ARABIC LETTER ZAIN FINAL FORM
FEB1	seen.isol	ARABIC LETTER SEEN ISOLATED FORM
FEB2	seen.fina	ARABIC LETTER SEEN FINAL FORM
FEB3	seen.init	ARABIC LETTER SEEN INITIAL FORM
FEB4	seen.medi	ARABIC LETTER SEEN MEDIAL FORM
FEB5	sheen.isol	ARABIC LETTER SHEEN ISOLATED FORM
FEB6	sheen.fina	ARABIC LETTER SHEEN FINAL FORM
FEB7	sheen.init	ARABIC LETTER SHEEN INITIAL FORM
FEB8	sheen.medi	ARABIC LETTER SHEEN MEDIAL FORM
FEB9	sad.isol	ARABIC LETTER SAD ISOLATED FORM
FEBA	sad.fina	ARABIC LETTER SAD FINAL FORM
FEBB	sad.init	ARABIC LETTER SAD INITIAL FORM
FEBC	sad.medi	ARABIC LETTER SAD MEDIAL FORM
FEBD	dad.isol	ARABIC LETTER DAD ISOLATED FORM
FEBE	dad.fina	ARABIC LETTER DAD FINAL FORM
FEBF	dad.init	ARABIC LETTER DAD INITIAL FORM
FEC0	dad.medi	ARABIC LETTER DAD MEDIAL FORM
FEC1	tah.isol	ARABIC LETTER TAH ISOLATED FORM
FEC2	tah.fina	ARABIC LETTER TAH FINAL FORM
FEC3	tah.init	ARABIC LETTER TAH INITIAL FORM
FEC4	tah.medi	ARABIC LETTER TAH MEDIAL FORM
FEC5	zah.isol	ARABIC LETTER ZAH ISOLATED FORM
FEC6	zah.fina	ARABIC LETTER ZAH FINAL FORM
FEC7	zah.init	ARABIC LETTER ZAH INITIAL FORM
FEC8	zah.medi	ARABIC LETTER ZAH MEDIAL FORM
FEC9	ain.isol	ARABIC LETTER AIN ISOLATED FORM
FECA	ain.fina	ARABIC LETTER AIN FINAL FORM
FECB	ain.init	ARABIC LETTER AIN INITIAL FORM
FECC	ain.medi	ARABIC LETTER AIN MEDIAL FORM
FECD	ghain.isol	ARABIC LETTER GHAIN ISOLATED FORM
FECE	ghain.fina	ARABIC LETTER GHAIN FINAL FORM
FECF	ghain.init	ARABIC LETTER GHAIN INITIAL FORM
FED0	ghain.medi	ARABIC LETTER GHAIN MEDIAL FORM
FED1	feh.isol	ARABIC LETTER FEH ISOLATED FORM
FED2	feh.fina	ARABIC LETTER FEH FINAL FORM
FED3	feh.init	ARABIC LETTER FEH INITIAL FORM
FED4	feh.medi	ARABIC LETTER FEH MEDIAL FORM
FED5	qaf.isol	ARABIC LETTER QAF ISOLATED FORM
FED6	qaf.fina	ARABIC LETTER QAF FINAL FORM
FED7	qaf.init	ARABIC LETTER QAF INITIAL FORM
FED8	qaf.medi	ARABIC LETTER QAF MEDIAL FORM
FED9	kaf.isol	ARABIC LETTER KAF ISOLATED FORM
FEDA	kaf.fina	ARABIC LETTER KAF FINAL FORM
FEDB	kaf.init	ARABIC LETTER KAF INITIAL FORM
FEDC	kaf.medi	ARABIC LETTER KAF MEDIAL FORM
FEDD	lam.isol	ARABIC LETTER LAM ISOLATED FORM
FEDE	lam.fina	ARABIC LETTER LAM FINAL FORM
FEDF	lam.init	ARABIC LETTER LAM INITIAL FORM
FEE0	lam.medi	ARABIC LETTER LAM MEDIAL FORM
FEE1	meem.isol	ARABIC LETTER MEEM ISOLATED FORM
FEE2	meem.fina	ARABIC LETTER MEEM FINAL FORM
FEE3	meem.init	ARABIC LETTER MEEM INITIAL FORM
FEE4	meem.medi	ARABIC LETTER MEEM MEDIAL FORM
FEE5	noon.isol	ARABIC LETTER NOON ISOLATED FORM
FEE6	noon.fina	ARABIC LETTER NOON FINAL FORM
FEE7	noon.init	ARABIC LETTER NOON INITIAL FORM
FEE8	noon.medi	ARABIC LETTER NOON MEDIAL FORM
FEE9	heh.isol	ARABIC LETTER HEH ISOLATED FORM
FEEA	heh.fina	ARABIC LETTER HEH FINAL FORM
FEEB	heh.init	ARABIC LETTER HEH INITIAL FORM
FEEC	heh.medi	ARABIC LETTER HEH MEDIAL FORM
FEED	waw.isol	ARABIC LETTER WAW ISOLATED FORM
FEEE	waw.fina	ARABIC LETTER WAW FINAL FORM
FEEF	alefmaksura.isol	ARABIC LETTER ALEF MAKSURA ISOLATED FORM
FEF0	alefmaksura.fina	ARABIC LETTER ALEF MAKSURA FINAL FORM
FEF1	yeh.isol	ARABIC LETTER YEH ISOLATED FORM
FEF2	yeh.fina	ARABIC LETTER YEH FINAL FORM
FEF3	yeh.init	ARABIC LETTER YEH INITIAL FORM
FEF4	yeh.medi	ARABIC LETTER YEH MEDIAL FORM
FEF5	lam.init_alef.medi_maddaabove.fina	ARABIC LIGATURE LAM WITH ALEF WITH MADDA ABOVE ISOLATED FORM
FEF6	lam.medi_alef.medi_maddaabove.fina	ARABIC LIGATURE LAM WITH ALEF WITH MADDA ABOVE FINAL FORM
FEF7	lam.init_alef.medi_hamzaabove.fina	ARABIC LIGATURE LAM WITH ALEF WITH HAMZA ABOVE ISOLATED FORM
FEF8	lam.medi_alef.medi_hamzaabove.fina	ARABIC LIGATURE LAM WITH ALEF WITH HAMZA ABOVE FINAL FORM
FEF9	lam.init_alef.medi_hamzabelow.fina	ARABIC LIGATURE LAM WITH ALEF WITH HAMZA BELOW ISOLATED FORM
FEFA	lam.medi_alef.medi_hamzabelow.fina	ARABIC LIGATURE LAM WITH ALEF WITH HAMZA BELOW FINAL FORM
FEFB	lam.init_alef.fina	ARABIC LIGATURE LAM WITH ALEF ISOLATED FORM
FEFC	lam.medi_alef.fina	ARABIC LIGATURE LAM WITH ALEF FINAL FORM
FEFF	zerowidthnobreakspace	ZERO WIDTH NO-BREAK SPACE